NO ./textures/wall_1.xpm
SO ./textures/wall_2.xpm
WE ./textures/wall_3.xpm
EA ./textures/wall_4.xpm

F 112,128,144
C 211,211,211

111111
100001
100E01
100001
111111
