111111111111
100000000001
100111110001
100100010001
1000N0000001
111111111111