111111
100001
10N 01
100001
110011