1111111
1     1
1  0  1
1 0N0 1
1     1
1111111