
NO ./textures/wood.xpm
SO ./textures/door.xpm
EA ./textures/brick.xpm
WE ./textures/cave.xpm

C 255,200,160
F 122,122,122

11111111111111111
10000000000000001
10000000000000001
10000000000000001
10000000000000001
10000000000000001
10000000000000001
1000000000N000001
10000000000000001
10000000000000001
10000000000000001
10000000000000001
11111111111111111

11111111111111111
10000000000000001
10000000000000001
10000000000000001
10000000000000001
10000000000000001
10000000000000001
10000000000000001
10000000000000001
10000000000000001
10000000000000001
11111111111111111
