NO ./textures/flower.xpm
SO ./textures/motif-jungle.xpm
WE ./textures/wallpaper1.xpm
EA ./textures/wallpaper2.xpm

F 241,228,200
C 233,233,222

        11111111111111111111111111111
        10000000001100000000000000001
        10110000011100000000000000001
        10010000000D00000000000000001
1111111110110000011100000000000000001
10000000001100000111011111D1111111111
11110111111111D1110000001000000000001
1111011111111101110000001000000000001
1100000011010101110000001000000000001
100000000000000001000000D000000000001
100000000000011111D111111000000000001
1100000111010100000000001000000000001
11110111 1110D00000N0000D000000000001
11110111 1110100000000001000000000001
11111111 1111111111111111111111111111
